111111
100C11
10CC01
10P0E1
111111