1111111111111111111111111111111111
1000000000000000000000000000P00001
100000000000000000000000000EC00001
1000000000000000000000000000000001
1000000000000000000000000000000001
1111111111111111111111111111111111